32 32 32 32 32 32 32 32 32 32 32 32 32 32 32 32 32 32 32 32 32 32 32 32 32 32 32 32 32 32 32 32 32 32 32 32 32 32 32 32 32 32 32 32 32 32 32 32 32 32
32 02 02 02 02 02 02 02 02 02 02 02 02 02 02 02 02 02 16 16 16 16 16 16 16 16 02 02 02 02 02 02 02 02 02 02 02 02 02 02 02 02 02 02 02 02 02 02 02 32
32 02 02 02 02 02 02 02 02 02 02 02 02 02 02 02 02 02 16 02 02 17 17 17 16 16 02 02 02 02 02 02 02 02 02 02 02 02 02 02 02 02 02 02 02 02 02 02 02 32
32 02 02 02 02 02 02 02 16 16 16 02 02 02 02 02 02 02 16 16 16 17 17 17 16 16 02 16 16 16 16 16 16 16 16 16 16 02 02 02 02 02 02 02 02 02 02 02 02 32
32 02 02 02 02 02 02 16 16 16 16 16 02 02 02 02 02 02 16 16 16 17 17 17 17 16 16 16 16 16 16 16 16 16 16 16 16 02 02 02 02 20 21 21 21 21 22 02 02 32
32 02 02 02 02 02 16 16 16 16 16 16 16 02 02 02 02 02 02 16 16 17 17 17 17 17 16 16 16 16 16 16 16 16 16 16 16 02 02 02 02 23 18 18 18 18 24 02 02 32
32 02 02 02 02 16 16 16 16 16 16 16 16 16 02 02 02 02 02 02 16 16 17 17 17 17 17 16 16 16 16 16 16 16 16 16 16 02 02 02 02 23 18 18 18 18 24 02 02 32
32 02 02 02 16 16 16 16 16 16 16 16 16 16 16 02 02 02 02 02 02 16 16 17 17 17 17 17 17 17 17 17 17 17 16 16 16 02 02 02 02 23 18 18 18 18 24 02 02 32
32 02 02 02 16 16 16 16 16 16 16 16 16 16 16 02 02 02 02 02 02 02 16 16 17 17 17 17 17 17 17 17 17 17 02 02 02 02 02 02 02 23 18 18 18 18 24 02 02 32
32 02 02 02 16 16 16 16 16 16 16 16 16 16 16 02 02 02 02 02 02 02 02 16 16 17 17 17 17 17 17 17 17 17 16 16 16 02 02 02 02 23 18 18 18 18 24 02 02 32
32 02 02 02 16 16 16 16 16 16 16 16 16 16 16 02 02 02 02 02 02 02 02 02 02 16 16 16 16 16 16 17 17 17 16 16 16 02 02 02 02 23 18 18 18 18 24 02 02 32
32 02 02 02 16 16 16 16 16 16 16 16 16 16 16 02 02 02 02 02 02 02 02 02 02 02 16 16 16 16 16 17 17 17 16 16 16 02 02 02 02 23 18 18 18 18 24 02 02 32
32 02 02 02 16 16 16 16 16 16 16 16 16 16 16 02 02 02 02 02 16 02 02 02 02 02 16 16 16 16 16 17 17 17 16 16 16 02 02 02 02 25 26 26 26 26 27 02 02 32
32 02 02 02 16 16 16 16 16 16 16 16 16 16 16 02 02 02 02 02 16 02 02 02 02 02 16 16 16 16 16 17 17 17 16 16 16 02 02 02 02 02 02 02 02 02 02 02 02 32
32 02 02 02 02 16 16 16 16 16 16 16 16 16 02 02 02 02 02 02 02 02 02 02 02 02 16 16 16 16 16 17 17 17 16 16 16 02 02 02 02 02 02 02 02 02 02 02 02 32
32 02 02 02 02 02 16 16 16 16 16 16 16 02 02 02 02 02 02 02 02 02 02 02 02 02 16 16 16 16 16 17 17 17 16 16 16 02 02 02 02 02 02 02 02 02 02 02 02 32
32 02 02 02 02 02 02 16 16 16 16 16 02 02 02 02 02 16 02 02 02 02 02 02 02 02 16 16 16 16 16 17 17 17 16 16 16 02 02 16 02 02 02 02 02 02 02 02 02 32
32 02 02 02 02 02 02 02 16 16 16 02 02 02 02 02 02 02 02 32 32 32 32 32 16 02 16 16 16 16 16 17 17 17 16 16 16 02 02 02 02 02 02 02 02 02 02 02 02 32
32 02 02 02 02 02 02 02 02 02 02 02 02 02 02 02 02 02 02 32 34 34 34 32 02 02 16 16 16 16 16 17 17 17 16 16 16 02 02 02 02 02 02 02 02 02 02 02 02 32
32 02 02 02 02 02 02 02 02 02 02 02 02 02 02 02 16 02 02 32 34 34 34 32 02 02 16 16 16 16 16 17 17 17 16 16 16 02 02 02 02 02 02 02 02 02 02 02 02 32
32 02 02 02 02 02 02 02 02 02 02 02 02 02 02 02 02 02 02 32 34 34 34 32 02 02 16 16 16 16 16 17 17 17 16 16 16 02 02 02 02 02 02 02 02 02 02 02 02 32
32 02 02 02 02 02 02 02 02 02 02 02 02 02 02 02 02 16 02 32 34 34 34 32 02 02 16 16 16 16 16 17 17 17 16 16 16 02 02 02 02 02 02 02 02 02 02 02 02 32
32 02 02 02 02 02 02 02 02 02 02 02 02 02 02 02 02 02 02 32 32 34 32 32 02 02 16 16 16 16 16 17 17 17 16 16 16 02 02 02 02 02 02 02 02 02 02 02 02 32
32 02 02 02 02 02 02 02 02 02 02 02 02 02 02 02 02 02 02 02 17 17 17 02 02 02 16 16 16 16 16 17 17 17 16 16 16 02 02 02 02 02 02 02 02 02 02 02 02 32
32 02 02 02 02 02 02 02 02 02 02 02 02 02 02 02 02 02 02 02 17 17 17 02 02 02 16 16 16 16 16 17 17 17 16 16 16 02 02 02 02 02 02 02 02 02 02 02 02 32
32 02 02 02 02 02 02 02 02 02 02 02 02 02 02 02 02 02 02 02 17 17 17 17 17 17 17 17 17 17 17 17 17 17 16 16 16 02 02 02 02 02 02 02 02 02 02 02 02 32
32 02 02 02 02 02 02 02 02 02 02 02 02 02 02 02 02 02 02 02 17 17 17 17 17 17 17 17 17 17 17 17 17 17 16 16 16 02 02 02 02 02 02 02 02 02 02 02 02 32
32 02 02 02 02 02 02 02 02 02 02 02 02 02 02 02 02 02 02 02 17 17 17 17 17 17 17 17 17 17 17 17 17 17 16 16 16 02 16 16 16 16 16 16 16 16 16 16 16 32
32 02 02 02 02 02 02 02 02 02 02 02 02 02 02 02 02 02 02 02 02 02 02 02 02 02 02 02 02 02 02 02 02 02 16 16 16 02 02 02 02 02 02 02 02 02 02 02 02 32
32 02 02 02 02 02 02 02 02 02 02 02 02 02 02 02 02 02 02 02 02 02 02 02 02 02 02 02 02 02 02 02 02 02 02 02 02 02 02 02 02 02 02 02 02 02 02 02 02 32
32 02 02 02 02 02 02 02 02 02 02 02 02 02 02 02 02 02 02 02 02 02 02 02 02 02 02 02 02 02 02 02 33 02 02 02 02 02 02 02 02 02 02 02 02 02 02 02 02 32
32 02 02 02 02 02 02 02 02 02 02 02 02 02 02 02 02 02 02 02 02 02 02 02 02 02 02 02 02 33 02 02 02 02 02 02 02 02 02 02 02 02 02 02 02 02 02 02 02 32
32 02 02 02 02 02 02 02 02 02 02 02 02 02 02 02 02 02 02 02 02 02 02 02 02 02 02 02 02 02 02 02 02 02 02 02 33 02 02 02 02 02 02 02 02 02 02 02 02 32
32 02 02 02 02 02 02 02 02 02 02 02 02 02 02 02 02 02 02 02 02 02 02 02 02 02 02 02 02 02 02 02 02 02 02 02 02 02 02 02 02 02 02 02 02 02 02 02 02 32
32 02 02 02 02 02 02 02 02 02 02 02 02 02 02 02 02 02 02 02 02 02 02 02 02 02 02 02 02 02 02 02 02 02 02 02 02 02 02 02 02 02 02 02 02 02 02 02 02 32
32 02 02 02 02 02 02 02 02 02 02 02 02 02 02 02 02 02 02 02 02 02 02 02 02 33 02 02 02 02 02 33 02 02 02 02 02 02 02 02 02 02 02 02 02 02 02 02 02 32
32 02 02 02 02 02 02 02 02 02 02 02 02 02 02 02 02 02 02 02 02 02 02 02 02 02 02 02 02 02 02 02 02 02 02 02 02 02 02 02 02 02 02 02 02 02 02 02 02 32
32 02 02 02 02 02 02 02 02 02 02 02 02 02 02 02 02 02 02 02 02 02 02 02 02 02 02 02 02 33 02 02 02 02 02 02 02 02 02 02 02 02 02 02 02 02 02 02 02 32
32 02 02 02 02 02 02 02 02 02 02 02 02 02 02 02 02 02 02 02 02 02 02 02 02 02 02 02 02 02 02 02 02 02 02 02 02 02 02 02 02 02 02 02 02 02 02 02 02 32
32 00 00 32 32 32 32 32 02 02 02 02 02 02 02 02 02 02 02 02 02 02 02 02 02 02 02 02 02 02 02 02 33 02 02 33 02 02 02 02 02 02 02 02 02 02 02 02 02 32
32 16 16 16 16 16 16 32 02 02 02 02 02 02 02 02 02 02 02 02 02 02 02 02 02 02 02 02 02 02 02 02 02 02 02 02 02 02 02 02 02 02 02 02 02 02 02 02 02 32
32 16 16 16 16 16 16 32 02 02 02 02 02 02 02 02 02 02 02 02 02 02 02 02 02 02 02 33 02 02 02 02 02 02 02 02 02 02 02 02 02 02 02 02 02 02 02 02 02 32
32 16 16 16 16 16 16 32 02 02 02 02 02 02 02 02 02 02 02 02 02 02 02 02 02 02 02 02 02 02 02 02 02 02 02 02 02 02 02 02 02 02 02 02 02 02 02 02 02 32
32 16 16 16 16 16 16 32 02 02 02 02 02 02 02 02 02 02 02 02 02 02 02 02 02 02 02 02 02 02 02 02 02 02 02 02 02 02 02 02 02 02 02 02 02 02 02 02 02 32
32 16 16 16 16 16 16 32 02 02 02 02 02 02 02 02 02 02 02 02 02 02 02 02 02 02 02 02 02 02 02 02 02 02 02 02 02 02 02 02 02 02 02 02 02 02 02 02 02 32
32 16 16 16 16 16 16 32 02 02 02 02 02 02 02 02 02 02 02 02 02 02 02 02 02 02 02 02 02 02 02 02 02 02 02 02 02 02 02 02 02 02 02 02 02 02 02 02 02 32
32 16 16 16 16 16 16 32 02 02 02 02 02 02 02 02 02 02 02 02 02 02 02 02 02 02 02 02 02 02 02 02 02 02 02 02 02 02 02 02 02 02 02 02 02 02 02 02 02 32
32 16 16 16 16 16 16 32 02 02 02 02 02 02 02 02 02 02 02 02 02 02 02 02 02 02 02 02 02 02 02 02 02 02 02 02 02 02 02 02 02 02 02 02 02 02 02 02 02 32
32 16 16 16 16 16 16 32 02 02 02 02 02 02 02 02 02 02 02 02 02 02 02 02 02 02 02 02 02 02 02 02 02 02 02 02 02 02 02 02 02 02 02 02 02 02 02 02 02 32
32 32 32 32 32 32 32 32 32 32 32 32 32 32 32 32 32 32 32 32 32 32 32 32 32 32 32 32 32 32 32 32 32 32 32 32 32 32 32 32 32 32 32 32 32 32 32 32 32 32