32 00 00 32 32 32 32 32 32 32 32 32 32 32 32 32
32 02 02 02 02 02 02 02 02 02 02 02 02 02 02 32
32 02 02 02 02 02 02 02 02 02 02 02 33 02 02 32
32 02 02 02 02 02 02 02 02 02 02 02 02 02 02 32
32 02 02 02 02 02 02 02 02 20 21 21 22 02 02 32
32 02 02 02 02 02 02 02 02 23 18 18 24 02 02 32
32 02 02 02 02 02 02 02 02 23 18 18 24 02 02 32
32 02 02 02 02 02 02 02 02 25 26 26 27 02 02 32
32 02 02 33 02 02 02 02 02 02 02 02 02 02 02 32
32 02 02 02 02 02 02 02 02 02 02 02 02 02 02 32
32 02 02 02 02 02 02 02 02 02 02 02 02 02 02 32
32 32 32 32 32 32 32 32 32 32 32 32 32 32 32 32